headword,successes,failures,total,failure_rate,high_failure
gon,0,168,168,1.0,YES
forgon,0,9,9,1.0,YES
don,29,164,193,0.8497409326424871,NO
putten,1,3,4,0.75,NO
clepen,1,2,3,0.6666666666666666,NO
seien,129,142,271,0.5239852398523985,NO
haven,114,116,230,0.5043478260869565,NO
helen,4,3,7,0.42857142857142855,NO
blouen,4,3,7,0.42857142857142855,NO
areden,2,1,3,0.3333333333333333,NO
greten,2,1,3,0.3333333333333333,NO
peinten,2,1,3,0.3333333333333333,NO
deliveren,2,1,3,0.3333333333333333,NO
shitten,2,1,3,0.3333333333333333,NO
withseien,2,1,3,0.3333333333333333,NO
asterten,2,1,3,0.3333333333333333,NO
imaginen,2,1,3,0.3333333333333333,NO
preien,18,7,25,0.28,NO
comen,31,12,43,0.27906976744186046,NO
paien,11,4,15,0.26666666666666666,NO
trouen,3,1,4,0.25,NO
undertaken,3,1,4,0.25,NO
ful-fillen,3,1,4,0.25,NO
touchen,3,1,4,0.25,NO
happen,3,1,4,0.25,NO
kissen,9,2,11,0.18181818181818182,NO
prien,5,1,6,0.16666666666666666,NO
sitten,5,1,6,0.16666666666666666,NO
letten,5,1,6,0.16666666666666666,NO
sweren,12,2,14,0.14285714285714285,NO
graunten,6,1,7,0.14285714285714285,NO
leten,6,1,7,0.14285714285714285,NO
senden,6,1,7,0.14285714285714285,NO
loken,6,1,7,0.14285714285714285,NO
holden,28,4,32,0.125,NO
slepen,15,2,17,0.11764705882352941,NO
pleien,40,5,45,0.1111111111111111,NO
hongen,8,1,9,0.1111111111111111,NO
quiten,8,1,9,0.1111111111111111,NO
chesen,9,1,10,0.1,NO
knouen,20,2,22,0.09090909090909091,NO
fonden,10,1,11,0.09090909090909091,NO
kepen,20,2,22,0.09090909090909091,NO
witen,11,1,12,0.08333333333333333,NO
lesen,11,1,12,0.08333333333333333,NO
wedden,11,1,12,0.08333333333333333,NO
taken,34,3,37,0.08108108108108109,NO
singen,26,2,28,0.07142857142857142,NO
failen,13,1,14,0.07142857142857142,NO
tellen,137,10,147,0.06802721088435375,NO
sheuen,14,1,15,0.06666666666666667,NO
faren,14,1,15,0.06666666666666667,NO
meten,15,1,16,0.0625,NO
thinken,15,1,16,0.0625,NO
maken,77,5,82,0.06097560975609756,NO
biginnen,16,1,17,0.058823529411764705,NO
stonden,22,1,23,0.043478260869565216,NO
winnen,26,1,27,0.037037037037037035,NO
bringen,33,1,34,0.029411764705882353,NO
biholden,39,1,40,0.025,NO
dien,85,2,87,0.022988505747126436,NO
wenden,20,0,20,0.0,NO
reden,26,0,26,0.0,NO
declaren,5,0,5,0.0,NO
ben,526,0,526,0.0,NO
crien,31,0,31,0.0,NO
chacen,3,0,3,0.0,NO
passen,30,0,30,0.0,NO
availen,12,0,12,0.0,NO
aspien,34,0,34,0.0,NO
finden,56,0,56,0.0,NO
ringen,6,0,6,0.0,NO
binden,11,0,11,0.0,NO
sterven,15,0,15,0.0,NO
deserven,12,0,12,0.0,NO
drauen,9,0,9,0.0,NO
fecchen,4,0,4,0.0,NO
forsaken,3,0,3,0.0,NO
seilen,4,0,4,0.0,NO
cleren,3,0,3,0.0,NO
rimen,3,0,3,0.0,NO
usen,4,0,4,0.0,NO
devisen,61,0,61,0.0,NO
purchasen,4,0,4,0.0,NO
liken,6,0,6,0.0,NO
prechen,9,0,9,0.0,NO
awaken,6,0,6,0.0,NO
risen,20,0,20,0.0,NO
dauncen,9,0,9,0.0,NO
thriven,13,0,13,0.0,NO
wondren,4,0,4,0.0,NO
displesen,6,0,6,0.0,NO
asken,10,0,10,0.0,NO
flen,12,0,12,0.0,NO
withstonden,5,0,5,0.0,NO
greven,10,0,10,0.0,NO
offenden,3,0,3,0.0,NO
amenden,7,0,7,0.0,NO
enditen,15,0,15,0.0,NO
bigilen,13,0,13,0.0,NO
serven,26,0,26,0.0,NO
sen,183,0,183,0.0,NO
receiven,6,0,6,0.0,NO
dwellen,36,0,36,0.0,NO
lien,29,0,29,0.0,NO
recchen,4,0,4,0.0,NO
strecchen,4,0,4,0.0,NO
isen,6,0,6,0.0,NO
assenten,15,0,15,0.0,NO
loven,17,0,17,0.0,NO
defenden,3,0,3,0.0,NO
siken,9,0,9,0.0,NO
departen,7,0,7,0.0,NO
eten,7,0,7,0.0,NO
fallen,41,0,41,0.0,NO
purveien,4,0,4,0.0,NO
smilen,3,0,3,0.0,NO
lepen,4,0,4,0.0,NO
casten,12,0,12,0.0,NO
gronen,9,0,9,0.0,NO
pleinen,21,0,21,0.0,NO
biwreien,9,0,9,0.0,NO
longen,4,0,4,0.0,NO
waken,9,0,9,0.0,NO
wepen,16,0,16,0.0,NO
sounen,3,0,3,0.0,NO
liven,27,0,27,0.0,NO
winden,5,0,5,0.0,NO
bleden,5,0,5,0.0,NO
dressen,6,0,6,0.0,NO
slen,28,0,28,0.0,NO
minen,3,0,3,0.0,NO
turnen,12,0,12,0.0,NO
cesen,4,0,4,0.0,NO
pressen,3,0,3,0.0,NO
escheuen,3,0,3,0.0,NO
writen,9,0,9,0.0,NO
despisen,5,0,5,0.0,NO
cherishen,4,0,4,0.0,NO
drinken,4,0,4,0.0,NO
heren,84,0,84,0.0,NO
leden,16,0,16,0.0,NO
entenden,4,0,4,0.0,NO
drien,3,0,3,0.0,NO
lasten,11,0,11,0.0,NO
descriven,10,0,10,0.0,NO
converten,3,0,3,0.0,NO
wrien,5,0,5,0.0,NO
apperen,7,0,7,0.0,NO
gladen,12,0,12,0.0,NO
leien,14,0,14,0.0,NO
saluen,3,0,3,0.0,NO
callen,25,0,25,0.0,NO
folden,3,0,3,0.0,NO
staren,3,0,3,0.0,NO
smiten,9,0,9,0.0,NO
abiden,32,0,32,0.0,NO
dinen,5,0,5,0.0,NO
japen,3,0,3,0.0,NO
plesen,19,0,19,0.0,NO
graven,3,0,3,0.0,NO
saven,13,0,13,0.0,NO
riden,35,0,35,0.0,NO
smerten,5,0,5,0.0,NO
quaken,7,0,7,0.0,NO
resten,9,0,9,0.0,NO
desiren,8,0,8,0.0,NO
arisen,10,0,10,0.0,NO
speken,21,0,21,0.0,NO
agrisen,4,0,4,0.0,NO
finen,4,0,4,0.0,NO
obeien,7,0,7,0.0,NO
blenden,5,0,5,0.0,NO
beren,16,0,16,0.0,NO
driven,13,0,13,0.0,NO
enduren,31,0,31,0.0,NO
countrefeten,11,0,11,0.0,NO
sweten,3,0,3,0.0,NO
rennen,5,0,5,0.0,NO
feinen,4,0,4,0.0,NO
waxen,6,0,6,0.0,NO
techen,18,0,18,0.0,NO
preisen,3,0,3,0.0,NO
glorifien,3,0,3,0.0,NO
reuen,12,0,12,0.0,NO
tarien,13,0,13,0.0,NO
sterten,4,0,4,0.0,NO
disporten,5,0,5,0.0,NO
avisen,7,0,7,0.0,NO
pouren,4,0,4,0.0,NO
bireven,4,0,4,0.0,NO
yeven,24,0,24,0.0,NO
gropen,3,0,3,0.0,NO
yelden,3,0,3,0.0,NO
welden,3,0,3,0.0,NO
sechen,18,0,18,0.0,NO
lernen,10,0,10,0.0,NO
werken,15,0,15,0.0,NO
sellen,13,0,13,0.0,NO
abien,4,0,4,0.0,NO
then,12,0,12,0.0,NO
parten,3,0,3,0.0,NO
demen,5,0,5,0.0,NO
knelen,3,0,3,0.0,NO
gien,7,0,7,0.0,NO
blamen,8,0,8,0.0,NO
bitiden,14,0,14,0.0,NO
sliden,4,0,4,0.0,NO
bifallen,5,0,5,0.0,NO
semen,9,0,9,0.0,NO
streinen,3,0,3,0.0,NO
duren,11,0,11,0.0,NO
striven,4,0,4,0.0,NO
hiden,13,0,13,0.0,NO
understonden,12,0,12,0.0,NO
descenden,6,0,6,0.0,NO
embracen,4,0,4,0.0,NO
redressen,5,0,5,0.0,NO
appesen,3,0,3,0.0,NO
atteinen,3,0,3,0.0,NO
spillen,4,0,4,0.0,NO
defacen,3,0,3,0.0,NO
chaungen,8,0,8,0.0,NO
suffisen,22,0,22,0.0,NO
slaken,3,0,3,0.0,NO
stinten,8,0,8,0.0,NO
enqueren,3,0,3,0.0,NO
giden,4,0,4,0.0,NO
repenten,8,0,8,0.0,NO
folwen,4,0,4,0.0,NO
weren,3,0,3,0.0,NO
hasten,3,0,3,0.0,NO
shaken,4,0,4,0.0,NO
aracen,3,0,3,0.0,NO
dispenden,3,0,3,0.0,NO
geten,3,0,3,0.0,NO
swinken,7,0,7,0.0,NO
speden,5,0,5,0.0,NO
drenchen,3,0,3,0.0,NO
comforten,5,0,5,0.0,NO
compleinen,7,0,7,0.0,NO
escapen,4,0,4,0.0,NO
lighten,7,0,7,0.0,NO
leren,16,0,16,0.0,NO
soren,5,0,5,0.0,NO
nevenen,5,0,5,0.0,NO
stiren,3,0,3,0.0,NO
beten,7,0,7,0.0,NO
carien,4,0,4,0.0,NO
flien,9,0,9,0.0,NO
avauncen,5,0,5,0.0,NO
preven,7,0,7,0.0,NO
leven,13,0,13,0.0,NO
felen,5,0,5,0.0,NO
discernen,3,0,3,0.0,NO
bileven,7,0,7,0.0,NO
biten,6,0,6,0.0,NO
gessen,8,0,8,0.0,NO
helpen,9,0,9,0.0,NO
approchen,4,0,4,0.0,NO
bithinken,5,0,5,0.0,NO
pipen,3,0,3,0.0,NO
envien,3,0,3,0.0,NO
romen,3,0,3,0.0,NO
iknouen,3,0,3,0.0,NO
honouren,6,0,6,0.0,NO
sustenen,5,0,5,0.0,NO
hien,7,0,7,0.0,NO
wernen,4,0,4,0.0,NO
connen,4,0,4,0.0,NO
solasen,3,0,3,0.0,NO
bresten,6,0,6,0.0,NO
furtheren,3,0,3,0.0,NO
eken,3,0,3,0.0,NO
repairen,3,0,3,0.0,NO
visiten,6,0,6,0.0,NO
bisechen,8,0,8,0.0,NO
yernen,3,0,3,0.0,NO
shapen,5,0,5,0.0,NO
trusten,5,0,5,0.0,NO
abreggen,5,0,5,0.0,NO
restreinen,6,0,6,0.0,NO
proceden,3,0,3,0.0,NO
rounen,4,0,4,0.0,NO
divinen,6,0,6,0.0,NO
colden,5,0,5,0.0,NO
excusen,3,0,3,0.0,NO
cursen,3,0,3,0.0,NO
wreken,3,0,3,0.0,NO
crepen,5,0,5,0.0,NO
trespassen,3,0,3,0.0,NO
deliten,3,0,3,0.0,NO
cacchen,3,0,3,0.0,NO
rehersen,5,0,5,0.0,NO
breken,4,0,4,0.0,NO
crouen,3,0,3,0.0,NO
chiden,7,0,7,0.0,NO
sojournen,4,0,4,0.0,NO
winken,4,0,4,0.0,NO
esen,3,0,3,0.0,NO
expressen,4,0,4,0.0,NO
multiplien,7,0,7,0.0,NO
concluden,4,0,4,0.0,NO
setten,3,0,3,0.0,NO
spenden,5,0,5,0.0,NO
herkenen,3,0,3,0.0,NO
wenen,4,0,4,0.0,NO
brennen,8,0,8,0.0,NO
dreden,11,0,11,0.0,NO
reven,3,0,3,0.0,NO
gliden,5,0,5,0.0,NO
encresen,5,0,5,0.0,NO
deren,4,0,4,0.0,NO
biwailen,3,0,3,0.0,NO
treten,6,0,6,0.0,NO
sufferen,6,0,6,0.0,NO
glosen,4,0,4,0.0,NO
stelen,5,0,5,0.0,NO
allien,4,0,4,0.0,NO
sparen,7,0,7,0.0,NO
missen,5,0,5,0.0,NO
biden,5,0,5,0.0,NO
werreien,3,0,3,0.0,NO
fighten,8,0,8,0.0,NO
recorden,3,0,3,0.0,NO
rekenen,3,0,3,0.0,NO
springen,10,0,10,0.0,NO
henten,4,0,4,0.0,NO
shenden,5,0,5,0.0,NO
accorden,3,0,3,0.0,NO
breiden,3,0,3,0.0,NO
twinnen,6,0,6,0.0,NO
brouken,3,0,3,0.0,NO
sorwen,4,0,4,0.0,NO
expounen,3,0,3,0.0,NO
asswagen,3,0,3,0.0,NO
bien,4,0,4,0.0,NO
